TILEMAP
images/tileSet3.png
16 16
11,33,23,24,25,26,23,24,25,26,23,24,25,26,23,24,25,26,23,24,25,26,23,24,25,26,23,24,25,26,34,14
27,28,0,0,0,0,0,0,0,0,0,0,0,0,0,0,0,0,0,0,0,0,0,0,0,0,0,0,0,0,29,30
43,44,0,0,0,0,0,0,0,0,0,0,0,0,0,0,0,0,0,0,0,0,0,0,0,0,0,0,0,0,45,46
59,60,0,0,0,0,0,0,0,0,0,0,0,0,0,0,0,0,0,0,0,0,0,0,0,0,0,0,0,0,61,62
11,12,0,0,0,0,0,0,0,0,0,0,0,0,0,0,0,0,0,0,0,0,0,0,0,0,0,0,0,0,13,14
27,28,0,0,0,0,0,0,0,0,0,0,0,0,1,2,1,2,1,2,1,2,1,2,1,2,0,0,1,2,29,30
43,44,1,2,1,2,1,2,1,2,0,0,0,0,15,40,40,41,42,42,42,39,40,41,42,47,0,0,15,41,45,46
11,63,40,41,42,42,42,39,40,47,0,0,0,0,45,56,56,57,58,55,56,55,56,57,58,44,1,2,45,57,61,62
27,33,24,25,26,25,26,23,24,49,0,0,0,0,50,24,24,25,26,25,26,23,24,25,26,49,0,0,50,25,13,14
43,44,0,0,0,0,0,0,0,0,0,0,0,0,0,0,0,0,0,0,0,0,0,0,0,0,0,0,0,0,29,30
59,60,0,0,0,0,0,0,0,0,0,0,0,0,0,0,0,0,0,0,0,0,0,0,0,0,1,2,0,0,45,46
11,12,0,0,0,0,0,0,0,0,0,0,0,0,0,0,0,0,0,0,0,0,0,0,0,0,0,0,0,0,61,62
11,12,0,0,1,2,1,2,0,0,0,0,0,0,0,0,0,0,0,0,0,0,0,0,0,0,0,0,0,0,13,14
27,28,0,0,0,0,0,0,0,0,0,0,0,0,1,2,1,2,0,0,1,2,1,2,1,2,1,2,1,2,29,30
43,44,0,0,0,0,0,0,0,0,0,0,0,0,15,40,41,47,0,0,15,40,41,42,42,42,39,40,41,42,31,46
59,60,1,2,1,2,1,2,1,2,0,0,1,2,45,8,9,44,0,0,45,56,57,58,55,56,55,56,57,58,57,62
27,63,39,40,41,42,39,40,41,47,0,0,0,0,50,24,25,49,0,0,50,24,25,26,25,26,23,24,25,26,34,14
6,56,57,56,57,58,55,56,57,28,1,2,0,0,0,0,0,0,0,0,0,0,0,0,0,0,0,0,0,0,29,30
6,56,57,56,57,57,58,57,58,28,0,0,0,0,0,0,0,0,0,0,0,0,0,0,0,0,0,0,0,0,45,46
6,56,55,56,57,57,58,57,58,44,0,0,0,0,0,0,0,0,0,0,0,0,0,0,0,0,0,0,0,0,13,14
22,56,57,55,56,57,58,58,58,60,1,2,1,2,1,2,1,2,1,2,1,2,1,2,1,2,1,2,1,2,29,30
38,56,57,56,55,55,55,56,57,63,39,40,41,42,39,40,41,42,39,40,41,39,40,40,41,42,39,40,41,39,31,46
TILEMAP
15.5 11.5	//Pos llave
5 4		//Pos puerta
27 16 0 	//Player
2		//Num enemigos
0 5 13 1
2 5 4 1

