TILEMAP
images/tileSet2.png
16 16
8,33,24,25,26,23,24,25,23,24,25,26,23,24,25,26,23,24,25,26,23,24,25,26,23,24,25,23,24,25,34,11
8,28,0,0,0,0,0,0,0,0,0,0,0,0,0,0,0,0,0,0,0,0,0,0,0,0,0,0,0,0,13,27
27,28,0,0,0,0,0,0,0,0,0,0,0,0,0,0,0,0,0,0,0,0,0,0,0,0,0,0,0,0,13,14
43,44,0,0,0,0,0,0,0,0,0,0,0,0,1,2,1,2,1,2,1,2,1,2,1,2,1,2,1,2,29,30
59,60,0,0,0,0,0,1,2,0,0,0,0,0,15,40,41,42,39,40,41,42,39,40,41,42,39,40,41,42,31,46
11,12,0,0,0,0,0,0,0,0,0,0,0,0,61,8,9,10,7,8,9,10,7,8,9,10,7,8,7,8,9,62
27,28,0,0,0,0,0,0,0,0,0,0,0,0,50,24,25,26,23,24,25,23,24,25,26,23,24,23,24,25,34,14
43,44,0,0,0,1,2,1,2,1,2,0,0,0,0,0,0,0,0,0,0,0,0,0,0,0,0,0,0,0,29,30
59,60,0,0,0,0,0,0,0,0,0,0,0,0,0,0,0,0,0,0,0,0,0,0,0,0,0,0,0,0,45,46
11,12,0,0,0,0,0,0,0,0,0,0,0,0,0,0,0,0,0,0,0,0,0,0,0,0,0,0,0,0,61,62
11,28,1,2,1,2,1,2,1,2,1,2,1,2,1,2,1,2,0,0,1,2,1,2,1,2,1,2,0,0,13,14
27,63,39,40,41,42,39,40,41,42,39,40,41,42,39,40,41,47,0,0,0,0,0,0,0,0,0,0,0,0,29,30
43,10,8,9,10,10,7,8,9,10,7,8,9,10,7,8,9,44,0,0,0,0,0,0,0,0,0,0,0,0,45,46
59,33,23,24,25,26,23,24,25,26,23,24,25,26,23,24,25,49,0,0,0,0,1,2,1,2,0,0,0,0,61,62
11,28,0,0,0,0,0,0,0,0,0,0,0,0,0,0,0,0,0,0,0,0,0,0,0,0,0,0,0,0,13,14
27,44,0,0,0,0,0,0,0,0,0,0,0,0,0,0,0,0,0,0,0,0,0,0,0,0,0,0,0,0,29,30
43,12,0,0,0,0,0,0,0,0,0,0,0,0,0,0,0,0,0,0,1,2,1,2,1,2,1,2,0,0,13,14
59,28,0,0,0,0,0,0,0,0,0,0,0,0,0,0,0,0,0,0,0,0,0,0,0,0,0,0,0,0,29,30
43,44,0,0,0,0,0,0,0,0,0,0,0,0,0,0,0,0,0,0,0,0,0,0,0,0,0,0,0,0,45,46
59,60,1,2,1,2,1,2,1,2,1,2,1,2,1,2,1,2,1,2,1,2,1,2,1,2,1,2,1,2,61,62
27,63,41,42,40,41,42,41,42,42,39,40,41,42,40,41,42,40,41,42,39,40,41,42,42,41,42,40,41,42,31,54
27,56,57,58,56,57,58,57,58,58,55,56,57,58,56,57,58,56,57,58,55,56,57,58,58,57,58,56,57,58,57,56
TILEMAP
23.5 8.5	//Pos llave
6 17		//Pos puerta
28 -1 0	 	//Player
2		//Num enemigos
0 23 8 1
2 4 17 1

