TILEMAP
images/tileSetD.png
16 16
19,33,23,24,25,26,23,24,25,26,26,23,24,25,23,24,25,26,24,25,23,24,25,26,24,25,23,24,25,26,34,22
11,12,101,102,0,0,0,0,0,0,0,0,0,0,0,0,0,0,0,0,0,0,107,108,0,0,0,0,79,0,13,14
11,12,117,0,0,0,0,0,0,0,0,0,0,0,0,0,0,0,0,0,0,0,123,124,0,0,0,0,95,0,13,14
11,12,0,0,64,0,0,0,0,0,0,0,0,0,0,0,0,0,0,0,0,0,0,0,0,0,0,0,111,0,29,30
27,28,0,0,80,0,0,0,0,0,0,0,0,0,0,0,0,0,0,0,0,0,0,0,0,0,0,0,127,0,45,46
43,44,0,0,96,0,0,0,1,2,1,2,1,2,1,2,1,2,1,2,1,2,1,2,0,0,0,0,0,0,13,14
59,60,0,0,0,0,0,0,0,0,0,0,99,100,29,67,70,28,0,0,0,0,0,0,0,0,0,0,0,0,29,30
11,28,0,0,0,0,0,0,0,0,0,0,115,116,45,84,85,44,0,0,0,0,0,0,0,0,0,0,0,0,45,46
27,44,0,0,0,0,1,2,1,2,1,2,1,2,61,84,85,28,1,2,1,2,1,2,1,2,0,0,0,0,61,62
43,28,0,0,0,0,0,0,0,0,0,0,0,0,45,84,85,44,0,0,0,0,0,123,124,0,0,0,0,0,13,14
59,44,0,0,0,0,0,0,0,0,0,0,0,0,61,84,85,60,0,0,0,0,0,0,0,0,0,0,0,0,29,30
11,60,0,0,1,2,1,2,1,2,1,2,1,2,50,23,24,49,1,2,1,2,1,2,1,2,1,2,0,0,45,46
27,44,0,0,0,123,124,0,0,0,0,0,0,0,0,0,0,0,0,0,0,0,0,0,0,0,0,0,0,0,61,62
43,60,0,0,0,0,0,0,0,0,0,0,0,0,0,0,0,0,0,0,0,0,0,0,0,0,0,0,0,0,13,14
59,60,0,0,1,2,1,2,0,133,0,0,0,0,0,0,0,0,0,0,0,0,133,0,1,2,1,2,0,0,29,30
11,12,0,0,0,0,0,0,0,149,0,0,0,0,0,71,72,0,0,0,0,0,149,0,0,0,0,0,0,0,45,46
27,28,0,0,0,0,0,0,0,0,0,0,0,0,0,87,88,0,0,0,0,0,0,0,0,0,0,0,0,0,13,14
43,44,0,0,1,2,0,0,0,0,0,0,0,0,0,103,104,0,0,0,0,0,0,0,0,0,1,2,0,0,29,30
59,28,0,0,0,0,0,0,0,0,0,0,0,0,0,0,0,0,0,0,0,0,0,0,0,0,0,0,0,0,45,46
27,28,0,0,0,0,0,0,0,0,125,126,0,0,0,0,0,0,0,0,0,0,0,0,0,0,0,0,0,0,61,62
43,44,1,2,1,2,1,2,1,2,1,2,0,0,0,0,0,0,0,0,1,2,1,2,1,2,1,2,1,2,29,30
59,63,39,40,41,39,40,41,39,39,40,47,16,16,16,16,16,16,16,16,15,39,40,41,40,41,39,39,40,41,31,46
TILEMAP
8.5 18.5	//Pos llave
20 3		//Pos puerta
2 16 true	//Player
4		//Num enemigos
0 8 18 0
0 22 18 1
1 7 9 1
1 25 9 0