TILEMAP
images/tileSet2.png
16 16
8,33,24,25,26,23,24,25,23,24,25,26,23,24,25,26,23,24,25,26,23,24,25,26,23,24,25,23,24,25,34,11
8,28,0,0,123,124,0,0,0,0,0,0,0,0,0,0,0,0,0,0,0,0,0,0,0,0,0,0,99,100,13,27
27,28,0,0,0,0,0,0,0,0,0,0,0,0,0,0,0,0,0,0,0,0,0,0,0,0,0,0,115,116,13,14
43,44,0,0,0,0,0,0,0,0,0,0,0,0,0,0,0,0,0,0,0,0,0,139,0,0,0,0,139,0,29,30
59,60,0,0,0,0,0,0,0,0,0,0,0,0,0,0,0,0,0,0,0,0,0,155,0,0,0,0,155,0,45,46
11,12,0,0,0,0,0,0,0,0,0,1,2,0,0,0,0,0,0,0,0,0,0,1,2,1,2,1,2,0,61,62
27,28,0,0,0,0,0,0,0,0,0,0,0,0,0,0,0,0,0,0,0,0,0,0,0,0,0,0,0,0,13,14
43,44,0,0,0,0,157,0,0,0,0,0,0,0,0,0,0,0,0,0,0,0,0,0,0,0,0,0,0,48,29,30
59,60,0,1,2,1,2,1,2,32,0,0,0,0,48,1,2,1,2,1,2,0,0,0,0,0,0,0,0,48,45,46
11,12,0,0,0,0,0,0,0,0,0,0,0,0,0,0,0,0,0,0,0,0,0,0,0,0,0,0,0,48,61,62
27,28,0,0,0,0,0,0,0,0,0,0,0,0,0,0,0,0,0,0,0,0,0,0,0,0,0,0,0,48,13,14
43,44,0,0,0,1,2,0,0,0,0,1,2,0,0,0,0,1,2,0,0,0,0,0,0,0,0,0,0,48,29,30
59,60,32,0,0,0,0,0,0,0,0,0,0,0,0,0,0,0,0,0,0,0,0,0,0,0,0,0,0,0,45,46
11,12,32,0,0,0,0,0,0,0,0,0,0,0,0,0,0,0,0,0,0,0,0,0,0,0,0,0,0,0,61,62
27,28,32,0,0,0,0,0,1,2,1,2,1,2,1,2,0,0,0,0,0,0,0,0,0,0,0,0,0,0,13,14
43,44,32,0,0,0,0,0,0,0,0,0,0,0,0,0,0,0,0,0,1,2,0,0,0,0,0,0,0,0,29,30
11,12,32,0,0,0,0,0,0,0,0,0,0,0,0,0,0,0,0,0,65,66,0,0,0,0,0,0,0,0,13,14
27,28,0,0,0,0,1,2,1,2,1,2,1,2,1,2,1,2,0,0,81,82,1,2,0,0,0,0,1,2,29,30
43,44,0,0,0,0,0,0,0,0,15,39,40,47,0,123,124,0,0,0,97,98,168,169,0,0,0,0,168,169,45,46
59,60,0,0,0,125,126,0,0,0,61,56,57,44,0,0,157,0,0,0,113,114,184,185,0,0,0,0,184,185,61,62
54,60,1,2,1,2,1,2,1,2,61,56,57,60,1,2,1,2,1,2,15,39,40,47,1,2,1,2,15,39,31,54
53,63,39,40,41,42,39,40,41,42,31,56,57,63,39,40,41,42,39,40,31,56,57,63,41,42,39,40,31,56,57,56
TILEMAP
25.5 18.5	//Pos llave
25 3		//Pos puerta
2 16 1		//Player
3		//Num enemigos
0 25 18 1
0 11 15 0
2 25 10 1
