TILEMAP
images/tileSetD.png
16 16
19,33,23,24,25,26,23,24,25,26,34,7,8,8,10,33,25,26,24,25,23,24,25,26,24,25,23,24,25,26,34,22
11,12,0,0,0,0,0,0,0,0,13,7,8,7,8,28,0,0,0,0,0,0,0,0,0,0,0,0,0,0,13,14
11,12,0,0,0,150,151,0,0,0,29,7,8,9,10,28,0,0,0,0,0,0,0,0,0,0,0,0,0,0,13,14
11,12,0,0,0,166,167,0,0,0,50,23,24,25,26,49,0,0,0,0,0,0,0,0,0,0,0,0,0,0,29,30
27,28,0,0,0,182,183,0,0,0,0,0,0,0,0,0,0,0,0,0,0,0,0,0,0,0,0,0,0,0,45,46
43,44,0,0,0,0,0,0,0,0,0,0,0,0,0,0,0,0,0,0,0,0,0,0,0,0,0,0,0,0,13,14
59,60,0,0,0,0,0,0,0,0,0,0,0,0,0,0,0,0,0,0,1,2,1,2,1,2,0,0,0,0,29,30
11,28,0,0,0,1,2,0,0,0,1,2,1,2,1,2,0,0,0,0,0,0,0,0,0,0,0,0,0,0,45,46
27,44,0,0,0,0,0,0,0,0,15,39,40,41,42,47,0,1,2,0,0,0,0,0,0,0,0,1,2,0,61,62
43,28,1,2,0,0,0,0,0,0,45,55,56,57,58,60,0,0,0,0,0,0,0,0,0,0,0,0,0,0,13,14
59,44,0,0,0,0,0,0,0,0,61,7,8,7,8,12,0,0,0,0,0,0,0,0,0,0,0,0,0,0,29,30
11,60,0,0,0,1,2,0,0,0,13,7,7,8,8,28,0,1,2,0,0,0,0,0,0,0,0,1,2,0,45,46
27,44,0,0,0,0,0,0,0,0,29,7,8,8,10,44,0,0,0,0,0,0,0,0,0,0,0,0,0,0,61,62
43,60,0,0,0,0,0,0,1,2,45,7,8,7,8,12,0,0,0,0,0,0,0,0,0,0,0,0,0,0,13,14
59,60,0,0,0,0,0,0,0,0,45,7,8,8,10,60,0,1,2,1,2,1,2,1,2,1,2,1,2,0,29,30
11,12,0,0,0,1,2,0,0,0,61,7,8,7,8,12,0,0,0,0,0,0,0,0,0,0,0,0,0,0,45,46
27,28,0,0,0,0,0,0,0,0,13,7,7,8,8,28,32,0,0,0,0,0,0,0,0,0,0,0,0,48,13,14
43,44,1,2,0,0,0,0,0,0,29,7,8,8,10,44,32,0,0,0,0,0,0,0,0,0,0,0,0,48,29,30
59,28,0,0,0,0,0,0,0,0,45,7,8,7,8,12,32,0,0,0,0,0,0,0,0,0,0,0,0,48,45,46
27,28,0,0,0,0,0,0,0,0,13,7,7,8,8,28,32,0,0,0,0,0,0,0,0,0,0,0,0,48,61,62
43,44,1,2,1,2,1,2,1,2,29,7,8,8,10,44,16,16,16,16,16,16,16,16,16,16,16,16,16,16,29,30
59,63,39,40,41,39,40,41,39,39,31,7,8,7,8,63,41,39,40,41,39,39,40,41,40,41,39,39,40,41,31,46
TILEMAP
5.5 5.5	//Pos llave
22 4		//Pos puerta
5 16 0 	//Player
1		//Num enemigos
0 21 12 1
1
1 2 18

