TILEMAP
images/blue-tileset.png
9 8
14,14,14,14,14,14,14,14,14,14,14,14,14,14,14,14
55,0,0,0,0,19,0,19,0,0,0,0,0,0,0,56
55,0,0,0,68,19,0,19,0,0,0,0,0,0,0,56
55,0,36,66,67,66,37,19,0,0,0,0,0,0,0,56
55,0,0,0,0,0,0,19,66,66,66,66,66,0,0,56
55,0,0,0,0,0,0,19,0,0,0,0,0,0,0,56
55,0,0,0,0,66,66,66,66,0,0,0,0,0,0,56
55,0,0,0,0,0,0,0,0,0,0,0,0,0,0,56
55,0,66,66,66,0,0,0,0,0,0,0,36,66,37,56
55,0,0,0,0,0,0,0,0,0,0,0,0,0,0,56
14,14,14,14,14,54,54,54,54,54,54,14,42,42,15,14
