TILEMAP
images/tileSet3.png
16 16
11,33,23,24,25,26,23,24,25,26,23,24,25,26,23,24,25,26,23,24,25,26,23,24,25,26,23,24,25,26,34,14
27,28,0,0,0,0,0,0,0,0,0,0,0,0,0,0,0,0,0,0,0,0,0,0,0,0,0,0,0,0,29,30
43,44,0,0,0,0,0,0,0,0,0,0,0,0,0,0,0,0,0,0,0,0,0,0,0,0,0,0,0,0,45,46
59,60,0,0,0,0,0,0,0,0,0,0,0,0,0,0,0,0,0,0,0,0,0,0,0,0,0,0,0,0,61,62
11,12,0,0,1,2,1,2,1,2,0,0,0,0,0,0,0,0,0,0,0,0,0,0,0,0,0,0,0,0,13,14
27,28,0,0,0,0,0,0,0,0,0,0,0,0,0,1,2,1,2,0,0,0,0,0,0,0,0,0,0,0,29,30
43,44,0,0,0,0,0,0,0,0,1,2,0,0,0,0,15,47,0,0,0,0,0,0,0,0,0,0,0,0,45,46
11,12,0,0,0,0,0,0,0,0,0,0,0,0,0,0,50,49,0,0,0,0,0,0,0,0,0,0,0,0,61,62
27,28,0,0,0,0,0,0,0,0,0,0,0,1,2,1,2,1,2,1,2,0,0,0,0,0,0,0,0,0,13,14
43,44,0,0,0,0,0,0,0,0,0,0,0,0,0,0,0,0,0,0,0,0,0,0,0,0,0,0,0,0,29,30
59,60,0,0,0,0,0,0,0,0,0,0,0,0,0,0,0,0,0,0,0,0,0,0,1,2,0,0,0,0,45,46
11,12,0,0,0,1,2,1,2,1,2,0,0,0,0,0,0,0,0,0,0,0,0,0,0,0,0,0,0,0,61,62
11,12,0,0,0,0,0,0,0,0,0,0,0,0,0,0,0,0,0,0,0,0,0,0,0,0,0,0,1,2,13,14
27,28,0,0,0,0,0,0,0,0,0,0,0,0,0,0,0,0,0,0,0,0,0,0,0,0,0,0,0,0,29,30
43,44,0,0,0,0,0,0,0,0,0,0,0,0,0,0,0,0,0,0,0,0,0,0,0,0,0,0,0,0,45,46
59,60,0,0,0,0,0,0,0,0,0,0,0,1,2,1,2,1,2,1,2,0,0,0,1,2,0,0,1,2,61,62
27,28,0,0,0,0,0,0,0,0,0,0,0,0,0,0,0,0,0,0,0,0,0,0,0,0,0,0,123,124,13,14
11,12,0,0,0,0,139,0,137,112,0,0,0,0,197,0,0,0,0,197,0,0,0,0,0,0,0,0,0,0,29,30
11,12,0,121,140,138,155,0,213,214,0,0,0,0,0,0,1,2,0,0,0,0,0,0,0,0,0,0,0,0,45,46
27,28,0,118,119,120,171,0,229,230,232,233,234,234,234,234,234,234,234,234,234,140,235,236,0,0,0,0,0,0,13,14
43,60,0,134,135,136,187,0,245,246,248,249,250,250,250,250,250,250,250,250,250,250,251,252,0,0,0,0,0,0,29,30
59,36,1,2,1,2,1,2,1,2,1,2,1,2,1,2,1,2,1,2,1,2,1,2,47,16,16,16,16,16,61,46
TILEMAP
6.5 2.5	//Pos llave
16 13		//Pos puerta
21 17 1 	//Player
2		//Num enemigos
1 3 19 1
0 5 9 1

